abk	Abkhasisk
ace	Achinesisk
ach	Acoli
ada	Adangme
afa	Afro-asiatiske sprog
afh	Afrihili
afr	Afrikaans
ain	Ainu
aka	Akan
akk	Akkadisk
alb	Albansk
ale	Aleutiske sprog
alg	Algonkiske sprog
amh	Amharisk
ang	Angelsaksisk
apa	Apache sprog
ara	Arabisk
arc	Aramæisk
arm	Armensk
arn	Araukansk
arp	Arapaho
art	Kunstsprog
arw	Arawak
asm	Assamesisk
ath	Athapascan
aus	Australske sprog
ava	Avarisk
ave	Avestisk
awa	Awadhi
aym	Aymará
aze	Aserbajdsjansk
bad	Banda
bai	Bamileke
bak	Bajkirsk
bal	Baluchi
bam	Bambara
ban	Balinesisk
baq	Baskisk
bas	Basa
bat	Baltiske sprog
bej	Beja
bel	Hviderussisk
bem	Bemba
ben	Bengali
ber	Berberiske sprog
bho	Bhojpuri
bih	Bihari
bik	Bikol
bin	Bini
bis	Bislama
bla	Siksika
bnt	Bantu
bos	Bosnisk
bra	Braj
bre	Bretonsk
btk	Batak
bua	Buriat
bug	Buginesisk
bul	Bulgarsk
bur	Burmesisk
cad	Caddo
cai	Mellemamerikanske indianske sprog
car	Caribisk
cat	Catalansk
cau	Kaukasiske sprog
ceb	Cebuano
cel	Keltiske sprog
cha	Chamorro
chb	Chibcha
che	Tjetjensk
chg	Chagatai
chi	Kinesisk
chk	Chuukese
chm	Mari
chn	Chinook
cho	Choctaw
chp	Chipewyan
chr	Cherokee
chu	Kirkeslavisk
chv	Tjuvasisk
chy	Cheyenne
cmc	Chamik sprog
cop	Koptisk
cor	Cornisk
cos	Korsikansk
cpe	Kreolsk
cpe	Pidgin
cre	Cree
crp	Kreolsk og pidgin
cus	Kusjitiske sprog
cze	tchèque
cze	Tjekkisk
dak	Dakota
dan	Dansk
day	Dayak
del	Delaware
den	Slave
dgr	Dogrib
din	Dinka
div	Divehi
doi	Dogri
dra	Dravidiske sprog
dua	Duala
dut	Hollandsk
dyu	Dyula
dzo	Dzongkha
efi	Efik
egy	Egyptisk
eka	Ekajuk
elx	Elamitisk
eng	Engelsk
enm	Middelengelsk
epo	Eperanto
est	Estisk
ewe	Ewe
ewo	Ewondo
fan	Fang
fao	Færøsk
fat	Fanti
fij	Fijian
fin	Finsk
fiu	Finsk - ugrisk
fon	Fon
fre	Fransk
frm	Middelfransk
fro	Oldfransk
fry	Frisisk
ful	Fulah
fur	Friulian
gay	Gayo
gba	Gbaya
gem	Germansk
geo	Georgisk
ger	allemand
ger	Tysk
gez	Geez
gil	Gilbertesisk
gla	Gælisk
gle	Irsk
glg	Gallegan
glv	Manx
gmh	Middelhøjtysk
goh	Oldhøjtysk
gon	Gondi
gor	Gorontalo
got	Gotisk
grb	Grebo
grc	Oldgræsk
grc	oldgræsk
gre	Græsk
grn	Guarani
guj	Gujarati
gwi	Gwich'in
gaa	Ga
hai	Haida
hau	Hausa
haw	Hawaiiansk
heb	Hebraisk
her	Herero
hil	Hiligaynon
him	Himachali
hin	Hindi
hit	Hittitisk
hmn	Hmong
hmo	Hiri motu
hrv	Kroatisk
hun	Ungarsk
hup	Hupa
iba	Iban
ibo	Igbo
ice	Islandsk
ijo	Ijo
iku	Inuktitut
ile	Interlingue
ilo	Iloko
ina	Interlingua
inc	Indiske sprog
ind	Indonesisk
ine	indo-européen
ine	Indoeuropæisk
ipk	Inupiaq
ira	Iranske sprog
iro	Irokesiske sprog
ita	Italiensk
jav	Javanesisk
jpn	Japansk
jpr	Jødisk-persisk
jrb	Jødisk-arabisk
kab	Kabyle
kac	Kachin
kal	Kalaallisut
kam	Kamba
kan	Kannaresisk
kar	Karen
kas	Kashmiri
kau	Kanuri
kaw	Kawi
kaz	Kasakhisk
kha	Khasi
khi	Khoisan
khm	Khmer
kho	Khotanesisk
kik	Kikuyu
kin	Kinyarwanda
kir	Kirgisisk
kmb	Kimbundu
kok	Konkani
kom	Komi
kon	Kongo
kor	Koreansk
kos	Kosraean
kpe	Kpelle
kro	Kru
kru	Kurukh
kua	Kuanyama
kum	Kumyk
kur	Kurdisk
kut	Kutenai
kaa	Karakalpakisk
lad	Ladino
lah	Lahnda
lam	Lamba
lao	Laotisk
lat	Latin
lav	Lettisk
lez	Lezghian
lin	Lingala
lit	Litauisk
lol	Mongo
loz	Lozi
ltz	Letzeburgesch
lua	Luba-lulua
lub	Luba-katanga
lug	Luganda
lui	Luiseño
lun	Lunda
luo	Luo
lus	Lushai
mac	Makedonsk
mad	Madurese
mag	Magahi
mah	Marshall
mai	Maithili
mak	Makasar
mal	Malayalam
man	Mandingo
mao	Maori
map	Malajo-polynesiske sprog
mar	Marathi
mas	Masai
may	Malajisk
mdr	Mandar
men	Mende
mga	Middelirsk
mic	Micmac
min	Minangkabau
mkh	Mon-khmer
mlg	Malagasy
mlt	Maltesisk
mnc	Manchu
mni	Manipuri
mno	Manobo
moh	Mohawk
mol	Moldovisk
mon	Mongolsk
mos	Mossi
mun	Munda
mus	Muskogee
mwr	Marwari
myn	Maya sprog
nah	Nahuatl
nai	Nordamerikanske indianske sprog
nau	Nauru
nav	Navaho
nbl	Sydndebele
nde	Nordndebele
ndo	Ndonga
nep	Nepalesisk
new	Newari
nia	Nias
nic	Niger-congo sprog
niu	Niuean
nmx	nama
nno	Nynorsk
nob	Bokmål
non	Oldislandsk
nor	Norsk
nso	Nordsotho
nub	Nubiske sprog
nya	Nyanja
nym	Nyamwezi
nyn	Nyankole
nyo	Nyoro sprog
nzi	Nzima
oci	Occitansk
oji	Ojibwa
ori	Orija
orm	Oromo
osa	Osage
oss	Ossetisk
ota	Osmannisk
oto	Otomi sprog
pag	Pangasinan
pal	Pahlavi
pam	Pampanga
pan	Panjabi
pap	Papiamento
pau	Paluansk
peo	Oldpersisk
per	Persisk
phi	Filippinske sprog
phn	Fønikisk
pli	Pali
pol	Polsk
pon	Ponape
por	Portugisisk
pra	Prakit
pro	Provencalsk
pus	Pashto
paa	Papua-australske sprog
que	Kechua
raj	Rajasthani
rap	Rapanui
rar	Rarotongan
roa	Romanske sprog
roh	Rætoromansk
rom	Romani
rum	Rumænsk
run	Rundi
rus	Russisk
sad	Sandawe
sag	Sango
sah	Yakut
sai	Sydamerikanske indianske sprog
sal	Salishan languages
sam	Samaritansk
san	Sanskrit
sas	Sasak
sat	Santali
sco	Skotsk
sel	Selkupisk
sem	Semitisk
ser	Serbokroatisk
sga	Oldirsk
shn	Shan
sid	Sidamo
sin	Singalesisk
sio	Siouan languages
sit	Sino-tibetanske sprog
sla	slave
sla	Slaviske sprog
slo	Slovakisk
slv	Slovensk
smi	Sami languages
smo	Samoansk
sna	Shona
snd	Sindhi
snk	Soninke
sog	Sogdiansk
som	Somali
son	Songe
sot	Sotho
spa	Spansk
srd	Sardinsk
srp	Serbisk
srr	Serer
ssa	Afrikanske sprog
ssw	Swati
suk	Sukuma
sun	Sundanesisk
sus	Susu
sux	Sumerisk
swa	Swahili
swe	Svensk
syr	Syrisk
tah	Tahitiansk
tai	Tai
tam	Tamil
tat	Tatarisk
tel	Telugu
tem	Temne
ter	Tereno
tet	Tetum
tgk	Tajik
tgl	Tagalog
tha	Thai
tib	Tibetansk
tig	Tigré
tir	Tigrinja
tiv	Tivi
tkl	Tokelau
tli	Tlingit
tmh	Tamashek
tog	Tonga
ton	Tonga
tpi	Tok pisin
tsi	Tsimshisk
tsn	Tswana
tso	Tsonga
tuk	Turkmensk
tum	Tumbuka
tur	Tyrkisk
tut	Tyrkisk-tatariske sprog
tvl	Tuvalu
twi	Twi
tyv	Tuvinian
uga	Ugaritisk
uig	Uigurisk
ukr	Ukrainsk
umb	Umbundu
urd	Urdu
uzb	Usbekisk
vai	Vai
ven	Venda
vie	Vietnamesisk
vol	Volapük
vot	Votisk
wak	Wakashan
wal	Walamo
war	Waray
was	Washo
wel	Walisisk
wen	Vendiske sprog
wol	Wolof
xho	Xhosa
yao	Yao
yap	Yap
yid	Jiddisch
yor	Yoruba
ypk	Yupik
zap	Zapotec
zen	Zenega
zha	Zhuang
znd	Zande
zul	Zulu
zun	Zuni
aar	Afar
111	Abazinsk
112	Adygisk
113	Agul
114	Akhvakh
115	Andi
116	Andi-sprogene
117	Artjinsk
118	Avarisk
119	Avaro-andi-dido-sprogene 
120	Bagulal
121	Bats
122	Bezhta
123	Botlikh
124	Budukh
125	Dagestanske sprog
127	Darginsk
128	Dargwa
129	Dido
130	Dido-sprogene
131	Godoberi
132	Grusis
133	Hinukh
134	Hunzib
135	Ingusjisk
136	Kabardinsk
137	Kaputji
138	Karata
139	Kartvelske sprog
140	Khinalug
141	Khjurkili
142	Khvarsji
143	Kolchidiske 
144	Kryts
145	Kuri
146	Lak
147	Lak - dargwa - sprogene
148	Laz
149	Lezgisk
150	Lezgiske sprog
151	Mingrelsk
152	Nakhsprog
153	Nordvestkaukasiske sprog
154	Nordøstkaukasisk
155	Nordøstkaukasiske sprog
156	Rutul
157	Svan
158	Tabasaran 
159	Tapanta
160	Tindi
161	Tjamalal
162	Tjan
163	Tjerkessisk
164	Tsakhur
165	Tsez
166	Tsova-tush
167	Ubykhisk
168	Udisk
169	Vesttjerkessisk
170	Zan
171	Østtjerkessisk
172	Ikke-indoeuropæiske sprog
173	Oldnordisk
174	ældre litauisk
175	archaisk
176	assyrisk
177	etruskisk
178	fælleslitauisk
179	gammelassyrisk
180	græsk-latin
181	ikke-germanske sprog
182	klassiske sprog
183	landsmål
184	oldkirkeslavisk
185	oldnorsk
186	oldslavisk
187	oskisk-umbrisk
188	østlitauisk
189	østzemaitisk
190	riksmål
191	samojedisk
192	serbo-kroatisk
193	tokharisk
194	uralske sprog
195	vestzemaitisk
196	vulgærlatin
197	zemaitisk
198	italisk
199	calabresisk – albansk
200	indisk
201	nyindisk
202	vedisk
203	attisk
204	kassitisk
205	nssqi
206	oskisk
207	umbrisk
208	østersøfinske
209	vogulsk
210	ostjakkisk
211	syrjænsk
212	tsjeremissisk
213	mordvinsk
214	lappisk
215	eskimoisk
216	miwok
217	achumawi
218	burushaski
219	maidu
220	byzantisk
221	Tabassaransk
222	Altasisk
223	Near Eastern languages
224	Pomo
225	Cantonese
226	Yuki
227	Kamtlaroy
228	kyrkansk
229	labarsaransk
230	lakkisk
231	aranda
232	Kalispel
233	ubychisk
234	Austrian
235	aranta
236	amerikansk
237	Paleosiberian
238	Gilyak
239	nordisk
340	tjuktjisk
341	oldeng
341	oldengelsk
342	jysk
343	Lilleasiatisk
344	Kamilaroi
345	rigsmål